%%%%%
%.P %
%%%o%
%.  %
%%%%%
